XXXXXXXXXXXXXXXXXXXXXXXXXXXXXXXXXXXXXXXXXXXXXXXXXXXXXXXXXXXXXXXXXXXXXXXXXXXXXXXXXXXXXXXXXXXXXXXXXXXX
X                                                                                                  X
X                                                                                                  X
X                                                                                                  X
X                                                                                                  X
X                                                                                                  X
X                                                                                                  X
X                                                                                                  X
X                                                                                                  X
X                                                                                                  X
X                                                                                                  X
X                                                                                                  X
X                                                                                                  X
X                                         TTTTTTTTTTTTT                                            X
X                                         T           T                                            X
X                                         T           T                                            X
X                                         T           T                                            X
X                                         T           T                                            X
X                                         T           T                                            X
X                                         TTTTTTTTTTTTT                                            X
X                                               T                                                  X
X                                               T                                                  X
X                                               T                                                  X
X                                               T                                                  X
X                                               T                                                  X
X                         TTTTTTTTTTTTTTTTTTTTTTTTTTTTTTTTTTTTTTTTTTTTTTTT                         X
X                                                                                                  X
X                                                                                                  X
X                                                                                                  X
X                                                                                                  X
X                                                                                                  X
X                                                                                                  X
X                                                                                                  X
X                                                                                                  X
X                                                                                                  X
X                                                                                                  X
X                                                                                                  X
X                                                                                                  X
X                                                                                                  X
X                                                                                                  X
X                                                                                                  X
X                                                                                                  X
X                                                                                                  X
X                                                                                                  X
X                                                                                                  X
X                                                                                                  X
X                                                                                                  X
X                                                                                                  X
X                                                                                                  X
X                                                                                                  X
X                                                                                                  X
X                                                                                                  X
X                                                                                                  X
X                                                                                                  X
X                                                                                                  X
X                                                                                                  X
X                                                                                                  X
X                                                                                                  X
X                                                                                                  X
X                                                                                                  X
X                                                                                                  X
X                                                                                                  X
X                                                                                                  X
X                                                                                                  X
X                                                                                                  X
X                                                                                                  X
X                                                                                                  X
X                                                                                                  X
X                                                                                                  X
X                                                                                                  X
X                                                                                                  X
X                                                                                                  X
X                                                                                                  X
X                                                                                                  X
X                                                                                                  X
X                                                                                                  X
X       TTTTTTTTTTTTTT     T           T      TTTTTTTTT       TTTTTTTTTTT      T               T   X
X       T            T     T           T     T         T      T          T     T               T   X
X       T            T     T           T     T         T      T          T     T               T   X
X       T                  T           T     T         T      T          T     T               T   X
X       T                  T           T     T         T      T        T       T               T   X
X       T                  TTTTTTTTTTTTT     TTTTTTTTTTT      T    TTTT        T               T   X
X       T                  T           T     T         T      T        T       T               T   X
X       T                  T           T     T         T      T          T     T               T   X
X       T            T     T           T     T         T      T          T     T               T   X
X       T            T     T           T     T         T      T          T     T               T   X
X       TTTTTTTTTTTTTT     T           T     T         T      TTTTTTTTTTT      TTTTTTTTTTT     T   X
X                                                                                                  X
X                                                                                                  X
X                                                                                                  X
X                                                                                                  X
X                                                                                                  X
X                                                                                                  X
X                                                                                                  X
X                                                                                                  X
X                                                                                                  X
X                                                                                                  X
X                                                                                                  X
X                                                                                                  X
XXXXXXXXXXXXXXXXXXXXXXXXXXXXXXXXXXXXXXXXXXXXXXXXXXXXXXXXXXXXXXXXXXXXXXXXXXXXXXXXXXXXXXXXXXXXXXXXXXXX