XXXXXXXXXXXXXXXXXXXXXXXXXXXXXXXXXXXXXXXXXXXXXXXXXXXXXXXXXXXXXXXXXXXXXXXXXXXXXXXXXXXXXXXXXXXXXXXXXXXX
XW                                                                                                WX
X                                                                                                  X
X                                                         T                                        X
X                                                                                                  X
X                                                                                        T         X
X          T                                                                                       X
X                                                                                                  X
X                                                                         T                        X
X                                                                                                  X
X                         WWWWWWWWWWWWWWW                                                          X
X                         WWWWWWQWWWWQWWW                                                          X
X                         WWWWWWWWWWWWWWW                                                          X
X                         WWWWWWWWWQWWWWW                                                          X
X                         WWWWQWWWWWWWWWW                T                                         X
X       T                 WWWWWWWWWWQWWWW                                                          X
X                         WWWWWWWWWWWWWWW                                                          X
X                         WWWWWWWWWWWWWWW                                                          X
X                                                                                                  X
X                                                                                                  X
X                                                                                                  X
X                                                                                                  X
X                               T                                                                  X
X                                                                                                  X
X                                                                                                  X
X                                                                    T                             X
X                      T                                                                           X
X                                                                                                  X
X                                                                                                  X
X                                                                                                  X
X                                                                                                  X
X                                                                                                  X
X                                                                                                  X
X                                                                         T                        X
X                                                                                                  X
X             T                                                                                    X
X                                                                                                  X
X                                                                                                  X
X                                            T                                                     X
X                                                                                                  X
X                                                                                                  X
X                                                                                                  X
X                                                                                                  X
X        T                                                                                         X
X                                                                                                  X
X                                                                                                  X
X                                  T                                                               X
X                                                                                                  X
XWWWWWWWWWWWWWWWWWWWWWWWWWWWWWWWWWWWWWWWWWWWWWWWWWWWWWWWWWWWWWWWWWWWWW                             X
XWWWWWWWWWWWWWWWWWWWWWWWWWWWWWWWWWWWWWWWWWWWWWWWWWWWWWWWWWWWWWWWWWWWWWW    T                       X
XWWWWWWWWWWWWWWWWWWWWWWWWWWWWWWWWWWWWWWWWWWWWWWWWWWWWWWWWWWWWWWWWWWWWWWW                           X
X                                                      WWWWWWWWWWWWWWWWWW                          X
X                                                       WWWWWWWWWWWWWWWWWWW                        X
X                                                        WWWWWWWWWWWWWWWWW                         X
X                                         T                WWWWWWWWWWWWW                           X
X                                                          WWWWWWWWWWWW                            X
X                                                           WWWWWWWWWWWWWWWWWWWWWWWWWWWWWWWWWWWWWWWX
X                                                             WWWWWWWWWWWWWWWWWWWWWWWWWWWWWWWWWWWWWX
X                                                               WWWWWWWWWWWWWWWWWWWWWWWWWWWWWWWWWWWX
X                                                                 W                                X
X            T                                                                                     X
X                                                                                                  X
X                                                                                 T                X
X                                                                                                  X
X                                                                                                  X
X                                          T                                                       X
X                                                                                                  X
X                                                                                                  X
X                                                                                                  X
X                                                                                                  X
X                                                        T                                         X
X               T                                                                                  X
X                                                                                                  X
X                                                                                                  X
X                                                                                                  X
X                                                                                                  X
X                                                                                                  X
X                                                                     T                            X
X                                      T                                                           X
X                                                                                                  X
X                                                                                                  X
X                                                                                                  X
X                                                                                                  X
X                                                                                                  X
X                                                                                                  X
X                                                                                                  X
X                                                                             T                    X
X                                                                                                  X
X                                                                                                  X
X                                                                                                  X
X                 T                                                                                X
X                                                                                                  X
X                                                                                                  X
X                                          T                                                       X
X                                                                                     T            X
X                                                                                                  X
X                                                                                                  X
X                                                                                                  X
XW                                                                                                WX
XXXXXXXXXXXXXXXXXXXXXXXXXXXXXXXXXXXXXXXXXXXXXXXXXXXXXXXXXXXXXXXXXXXXXXXXXXXXXXXXXXXXXXXXXXXXXXXXXXXX